1111111111111111111111111111111111
1E00000000000000000100000000000011
1010010100100000101001010000010101
1010110010101011001001000100010101
1P00000100000000000000000001000001
1111111111111111111111111111111111
