111111111
100010001
10P000001
100001001
100000001
111111111
