11111111111111111111111
11111111000000011111111
11111111000000011111111
11111111000000011111111
11111111000000011111111
11111111000000011111111
10000000000000000000001
1000000000P000000100001
10000000000000000000001
11111111000000011111111
11111111000000011111111
11111111000000011111111
11111111000000011111111
11111111111111111111111
