11111111111111111111111
1000000000000000000C1E1
10000001001011100000101
100000010C1000010000101
10000000111011110000001
1C00000000101C000000001
11110000001001110000001
1P000000000000000000001
11111111111111111111111
