11111111111111111111111111
1P111111111111111111110E11
10111111111111111111110011
10000100010001000010100011
11011101110101011110101011
1100010000C000010010101011
11110000110011001000001011
11000100010101000000100011
11111111111111111111111111
10111111111111111111111011
11111111111111111111111111